NO textures/player.xpm
SO textures/exit.xpm
WE textures/tree.xpm
EA textures/object.xpm

F 220,100,0
C 225,30,0

111111111
100000001
101000111
111001101
100000101
1010E0101
100000001
111111111