NO textures/bricks2.xpm
SO textures/brick.xpm
WE textures/bricks2.xpm
EA textures/brick.xpm

F 97,95,99
C 102,178,227

 111111111111111111111
10000000000S00000000001
 100000000000000000001
  1000000000000000001
   10000000000000001
    100000000000001
     1000000000001
      10000000001
       100000001
        1000001
         10001
          101
           1